366661312
313644231
235146662
k36443c12
264364146
643413125
462636432