3666123661
36626466l3
2664316264
6332244612
5314366635
4626621224
c224212634
4436333666