41666266
c1662444
46644n34
16136265
63261116
63122146
42444466
21666664