4313132216234
3436635331633
5665366362326
62616241c1134
3464456516345
63m6516624512
1644521556231
5454645324625
3236341426123
1666633623444
1321251241664