1n211661
56654213
51214631
6a116614
44654234
21236664