166621412
441636146
1351625c6
326616626
346546664
k34462416
646662664